5 13 31
###############################
#p * *3       *  ** * *      *#
# # # # #*# # #*# # # # # #*# #
#    * * *** **  5   *    **  #
# #*# # # # #4# #b# # # # # #*#
#          *     **      *  **#
# # #*# # # # # #*#*#*#*# # # #
#   *        *   * *x* *   4  #
# # # # #*# # # # # # #*# #*# #
#   ****  2      *2           #
# # # # # # # # # #*# # # # #*#
#  ** *   *                   #
###############################