4 13 31
###############################
#p    * **    *   3           #
# # # #*# # # # # # # # # # # #
#      ** * *  *   * ** 3 *   #
# # # # # #*# # # # # # #*# # #
#*   * *    *w* *   **        #
# # # # # # # # # # # # # #*# #
#    *     *    2   *    **  3#
# #*# # #*#*#*#*# # # # # #*# #
#          4 *      * 4 *     #
#*# # # # # # # # # # #*# # #*#
#x*    * **    ** ***         #
###############################